
NO ./pics/greyBrickWall2.xpm
SO ./pics/textureStone.xpm
WE ./pics/StoneWall.xpm
EA ./pics/StoneBricks.xpm
CT ./pics/woodTexture.xpm
FT ./pics/TileBrown.xpm

F 117,72,8
C 108,199,204

                         11                                                       11
                        11111                                                    1111
                        110011                                                 111001
                        1100011           11111111111111111111111111111      11100001
                        100010111         11111111111111111111111111111      100010011
                       11001110011    111111000000000000000000000000001111   100111001
                       1101111101111111000000000000000000000000000000000011111011111011
                      1100000100000000000000000000000000000G0000000000000ED000000100011
                     1100000001111111111100000000000000000000000000000000110000001000011
                     1100000000000000001100000000000000000000000000000000110000001000011
                    11000000000000000000110000000000000000000000000000000110000001000011
                   1100000000000000000000110000000000000000000000000000111111111110000011
                   1100000000000000000000010000000000000000000000000011100000000000000011
                   11000000000000000000000111111111111111111111111111100000000000000000011
                  110000000000000000000000000000001110000000000000000000000000000000000011
                  110000000000000000000000000000011100000000000000001000000000000000000011
                  110000000000000000000001000000111000010000000000001111111111111111111111
                 11000000000000000000000001111111111111000110000000000000000000000000000011
                 11000000000000000000000000000111000011000110000000000000000000000011100011
                 11000011010000011111111111111111111101101101111111111111111111101100000011
                110001100101111011     1     1      101101101     1     1      1000011000011
                110000001000000001    1  111  1    11011011011   1  111  1    11011000110011
                1100001110000111011   1  1D1  1  11100010100011  1  1D1  1   1101001100000011
                11000000001010000011  1  1D1  1 110000001000011  1  1D1  1  11001100011100011
               1100000111101000010011 1  111  111000000000000011 1  111  1 110100110000000011
               110000100000001110010111       11100000000000010111       11101010001101100011
               1100000011101100001000111     1100000000000011000111     1110010111000110000011
               1100000100010000010100011111111000001000000100000011111111100100100100010000011
              11000001000100001000000111000000001010000000010000001111111000010010010000000011
              11000000000000000111111111111111110100000000001000000111110000001010000000000011
             110000000000000000000011100000000001000000000000100000011100000000100000000000011
             110000000000000010000111000010000010000000000000010000001000000000100000000000011
             1100000000000000011111111111000001000000000000000010000000000000000100000001010111
            11000000000000000001110000000000010000111110111110001000000101000001000001010100111
            11000000000000000111000000000000100000001111111000000100000010000000000000100000011
            11000000000000001110000000000001000000000011100000000010000101010000000101010000011
            11000000000000011100000000000000000000000000000000000000000000111001001110000000011
            110000000000000000000000000000000000000000000000000000000000010011111110010000000011
            110000000000000000000000000000000000000000000000000000000000000000010000000000000011
            110000000000000000000001111111111111111111111111111111111111110000000000000000000011
            110000000000000000000011111111111111111111111111111111111111111000000000000000000011
             11000000000000000000111111111111111111111111111111111111111111100000000000000000011
             11000000000000000001111111111111111111111111111111111111111111110000000000000000011
             11000000000000000011111111111111111111111111111111111111111111111000000000000000011
             11000000000000000111111111111111111111111111111111111111111111111100000000000000011
             11000000000000001111111111111111111111111111111111111111111111111110000000000000011
             1100111100000001111111111111111111111111111111111111111111111111111100000001111011
              110100000000000000000000000000000000000000000000000000000000000000000000000001011
              110001111111111111111111111111111111111111111111111111111111111111111111111000011
              110000100000000000000000000000000000000000000000000000000000000000000000110000011
              11000001000000000000000000000000000000000000000000001110000000000000000110000011
               1100000111111111111111111111111111111111111111111111011000011111111111100000011
               1100000010000000000000000000000000000000000000000000001100110000000011000000011
               110000001100000000000000000000000000000000000000000000010110000000011000000011
               110000000110000000000000000000000000000000000000000000001000000000110000000011
               110000000011111111111111111111111111111111111111111111111111111111100000000011
                1100000000000000000000000000000000000000000000000000000000000000000000000011
                1100000000000000000000000000000000000000000000000000000000000000000000000011
                1100000000000000000000000000000000000000000000000000000000000000000000000011
                1100000000000000000000000000000000000000000000000000000000000000000000000011
                 11000000000000000000000000000000000000000000000000000000000000000000000011
                 11000000000000000000000000000000000000000000000000000000000000000000000011
                 11000000000000000000000000000000000000000000000000000000000000000000000011
                  1110000000000000000000000000000000000000000000000000000000000000000000011
                    11000000000000000000000000000000000000000000000000000000000000000000111
                    1100000000000000000000000000000000000000000000000000000000000000000011
                     110000000000000000000000000000000000000000000000000000000000000000011
                     111000000000000000000000000000000000000000000000000000000000000000011
                       110000000000000000000000000000000000000000000000000000000000000011
                       11000000000000000000000000000000000000000000000000000000000000111
                        111000000000000000000000000000000000000000000000000000000000011
                          111000000000000000000000000000000000000000000000000000000111
                          111000000000000000000000000000000000000000000000000000000111
                          111110000000000000000000000000000000000000000000000000011111
                            1111110000000000000000000000000000000000000000000011111
                             111111000000000000000000000000000000000000000000111111
                               111111000000000000000000000000000000000000111111
                                    111111000000000000000000000000000111111
                                        1111110000000000000000000111111
                                          11111111111111111111111111