


NO ./pics/greyBrickWall2.xpm
SO ./pics/textureStone.xpm
WE ./pics/StoneWall.xpm
EA ./pics/StoneBricks.xpm
CT ./pics/woodTexture.xpm
FT ./pics/TileBrown.xpm


F 117,72,8
C 108,199,204


       11111111111111111111111111111111111111111111
       10000TK000000T00T1B000TT00000000000000000001
       100100000000000000000000000000011111100000T1
       100100000S000C000000000000001111    11110001
       100D000000000000T1L0B000000010K111111K010001
       1001001D1D11111D11101111K000100010V100010001
       101100001D1010101100K111000000001G01T0000011
       1001T0001D11110011L00000000000000000000000R1
       1001000000100000111111D11111111111111000011111111111
111111110000000K11100001    101            10000000000000R1
1TT00000000000T110001111    101            1L10000000000011
100000011110111111111111    10111111111111 1111111111110001
111011111110111111111111    10000000000VK1            10001111111
1K00000000000000000000B1    10000000000001111111111111100000B0011
111111011110111111111111    10000111000000000000000000D0000000011
111111011110111111111111    1T0001 100000111111111111110000T00011
1TTT00000110110T000100T1    10000111000001         10000000000011
1T0000000000110010010001    10000000000001         1T00000V000011
1T0000000110110000011011    10000000000BT1         10000000000011
10101K000110000010000001    10111111111111         110000000K0011
11111111111111111111111111111111111111111111111111111111111111111
